24 24
111111111111111111111111
100000000011000000000001
101100000111000000200001
100100000000000000000001
100000000000000011000001
110000011011000111000001
111101111111101111010001
111101111111101111010001
110000011111000000000001
100000000000000000000001
100000000000000000000001
100000000000000000000001
100000000000000000000001
100000000000000000000001
100000000000000000000001
100000000000000000000001
100000000000000000000001
100000000000000000000001
100000000000000000000001
100000000000000000000001
100000000000000000000001
100000000000000000000001
100000000000000000000001
111111111111111111111111
