1111111111111111111111111111111111111111111
1100000000000000000000000000000000000000001
1100000000000000000000000000000000000000001
1100000000000000000000000000000000000000001
1111111111110000000000001111111111111111111
1100000000000000000000000000000000000000001
1100000000000000001000000000000000000000001
1100000000000000001000000000000000000000001
1100000000000000001000000000000000000000001
1100000000000000000000000000000000000000001
1100000000000000000000000000000000000000001
1000000000000011111111111000000000000000001
1000000000000000000000000000000000000000001
1111111111110000000011111111111111111111111
1000000000000000000000000000000000000000001
1000000000000000000000000000000000000000001
1111111111111111111111111111111111111111111
